R 500 500
NO ./texture/tron0.xpm
SO ./texture/tron0.xpm
WE ./texture/tron0.xpm
EA .//texture/tron0.xpm
S ./texture/tron3.xpm
F 0,0,0
C 0,0,0


        1111111111111111111111111                111111111
        10000000000000000000000011111111111111111000000001
        10000000000000000000000000000000000000000000000011
        10000000000000000000000011111111111111111100000011
111111111001000000000000000000001                111111111
100000000000100000000000111111111
10000000000001000000000010001
1111000000000010000000001111111111111111111111111
1100000000000001000000000000000000000000000000001
1000000000000000100000000020000000000000000011111
1000000000000000000000000000000000000000000000001
11000001110101011111011110N0111111111111111111111
11110111 1110101 101111010001
11111111 1111111 111111111111
