R 1920 1080
NO ./texture/tron0.xpm
SO ./texture/tron2.xpm
WE ./texture/tron2.xpm
EA .//texture/tron0.xpm
S ./texture/tron3.xpm
F 0,0,0
C 0,0,0


        1111111111111111111111111                111111111
        10000000000000000000000011111111111111111000000001
        10000000200000000000000000000000000000000000000011
        10000000000000000000000011111111111111111100000011
111111111000000000000000000000001                111111111
100000000000000000000111111111111
10000000000000000000000010001
11110111011011011011011011111
11000000000000000000000000001
10000000200000000000020000001
10000000000000000000000000001
11000001110101011111011110N0111
11110111 1110101 101111010001
11111111 1111111 111111111111
